############
########1CBA3zoijh#
#LKJIHGFECDA2bncj#
#NKM###FOPWX##
#####TSRQPZXY#
#####USV######
##############
