#####BA5###
####CBA4###
###3CDQRSVW
###YEFQRSV#
##ZHGJK####
#1MHI######
2NM#L######
P##########
