###############
######3A4######
######5ABC2####
#####GFEDC#####
#MLIHGOEPQRWXY#
#MNIJK##TSRZ1##
#####K#VTU#####
###############
