###################
#######A4##########
######3ABCDE#######
#####1QPBCDEFGHIJK#
##YTSRQP#######IJK#
#XWTSR#############
###################
