##############
########1CBA3#
#LKJIHGFECDA2#
#NKM###FOPWX##
#####TSRQPZXY#
#####USV######
##############
